.	.	.	.	.	.	.	1
2	3	.	.	.	.	.	.
.	.	.	.	.	.	.	.
.	4	.	5	.	.	2	.
.	.	.	.	.	.	6	.
6	.	.	.	.	.	.	.
5	4	.	.	3	.	.	.
.	.	.	.	.	.	1	.