1	2	3	.	.	.	.	.	.	.	.	.	.	.
.	.	.	.	.	.	.	.	.	.	.	.	.	.
.	.	.	.	4	.	.	.	.	5	.	.	6	.
.	.	.	.	.	.	.	.	.	.	.	.	5	7
.	8	.	.	.	.	.	.	.	7	.	.	.	.
.	.	.	.	.	.	.	.	.	.	.	.	9	6
.	.	.	.	.	.	.	.	.	.	.	.	.	.
.	.	.	.	.	.	.	.	.	.	A	.	.	.
.	.	.	.	.	.	.	3	.	B	1	.	.	.
.	.	.	.	.	.	.	.	.	.	9	.	.	.
.	.	.	.	.	.	4	.	.	.	2	.	.	.
.	.	.	.	.	.	.	.	.	.	.	.	.	.
B	A	8	.	.	.	.	.	.	.	.	.	.	.
.	.	.	.	.	.	.	.	.	.	.	.	.	.