.	.	.	.	.	.	.	.	.	.	1	.	.	1
.	.	.	.	.	.	.	.	.	.	.	.	.	.
.	.	2	3	4	5	.	.	.	.	.	.	.	.
.	.	.	.	.	.	.	.	.	.	6	7	.	.
.	.	.	.	.	.	4	5	.	.	8	.	.	.
.	.	.	.	.	.	6	.	.	.	9	.	.	.
.	.	.	.	.	.	.	.	.	.	.	.	.	.
.	.	8	A	.	.	.	.	.	.	.	7	.	.
.	.	.	.	.	.	.	.	B	.	B	C	.	.
.	3	.	.	.	.	.	.	.	D	.	.	.	.
.	E	.	.	.	E	.	A	.	.	D	.	.	.
.	.	.	.	.	.	.	.	.	9	C	.	.	.
.	.	F	.	.	.	.	F	.	.	.	.	.	.
2	.	.	.	.	.	.	.	.	.	.	.	.	.