.	.	.	.	.	.	.	.	.	.	.	.	.	.
.	1	.	.	.	1	.	.	.	.	.	.	.	.
.	.	.	.	.	.	.	.	.	.	.	2	.	.
.	.	.	.	.	.	.	.	3	.	.	.	.	.
.	5	.	.	.	.	.	.	.	.	4	.	.	.
.	.	.	6	2	.	7	.	.	.	.	.	.	.
.	.	8	.	8	.	.	6	.	.	.	.	.	.
4	.	.	.	.	.	.	7	.	.	.	9	.	.
.	.	.	.	9	.	.	a	.	d	.	.	.	.
.	.	.	.	b	.	.	b	.	e	.	.	.	.
.	.	c	a	.	.	.	.	.	.	.	.	.	f
.	.	.	.	c	.	.	.	.	.	d	.	.	.
.	.	.	.	.	.	.	.	.	.	.	.	5	.
.	.	.	.	.	.	.	e	.	3	f	.	.	.